1524242423141200000500022324143222121512
3525243500070a00000100001b1c1f1315123314
3207000f08000004000002003b3c3d2e2f233515
0000020108020208020000020100060907331415
0b00000010110000010004000002070002233224
010100012021000000050b010c01010001130002
0d00000000000500050000010102000000130201
0000000d02050607000002020100010100230200
320000090b000000010001000000010200230106
2522221423353235131222232213222535242435
1233332224322435332534241315342223131333

image outdoors
hero @9,5
location 16 16
