7997979797979804000500029697977a87878787
88331332000200020001000a01000096977a8787
9802000f08000004000002000202000001868787
000002010802020802000000020f000002868787
0b00000010110000010004000002070001969797
010100012021000000050b010c01010000340000
0d00000000000500050000010102000000130201
080c000d02050607000002020100010100230200
7778090b00000000010001000000010200230200
8789777824353235131222232213222535251276
878787882532243533253424131534222313768a

image image:outdoors
hero @9,5
location 16 16
