7896969696969702000500009596967986868686
87243415000002000001000d0d01009596798686
970e000f08000004000002000202000001858686
020002010802020802000000020f000000858686
0b00000010110000010004000002070000959696
010100012021000000050b010c0101000033000a
0d00000000000500050000010102000000130201
0200000d02050607000002020100010100230200
7677090b00000000010001000000010200230201
8688767714353235131222232213222535253475
8686868712322435332534241315342223237589

image outdoors
hero @9,5
location 16 16
