1500000001000f00000500020201010400000014
0000000b01000e0c00010d0000000f0507020100
02062200000001050000000016171718000d0000
01000a0100cacbcccdcecf012627272918000b02
0d0c010d00dadbdcdddedf00361a272728010000
0015060107eaebecedeeef0600262727280a000c
0000000002fafbfcfdfeff040126193738060001
0000000d030100000d0c00020136380000080600
250000000a0b0000000205000000000100070301
233500000201020d0d0801000c0f000002002212
3222323533151501000200000301010125322333

image outdoors
hero 6 7
