3432333323132534131535341402000100020722
1332223434231225352513223201000002000125
2514350a00000001253525322500000009020912
153401071b1c1f000033143413080d0000090f13
3424080c2b2c2d2e2f02000d0200000101000212
2232000007020a00020c020108000700010d0033
2225000003000800000c01020000000200001224
1212130001020001020000020000000e33252512
1524151322231335352325133532131335223513
3532141232232433232314131433241223351214
2215151425352333342225332413142214323435

image outdoors
location 18 17
sprite @3,6 candle2
