3522152435321513342512321224333222333225
35070f0600000e06010000000103010000000f13
2503000001020001000e0b0200010000000e0d34
340001a3a3a3a3a3a3a3a3a3a3a3a30200000034
000202a3a3a3a3a3a3a3a3a3a3a3a30001030232
020000a3a3a3a3a3a3a3a3a3a3a3a30b000c0425
13a3a3a3a3a3a3a3a3a3a3a30100080b02010012
35a3a3a3a3a3a3a3a3a3a3a30309010a08020115
a3a3a3a3a3a3a3a3a3a3a3a30100020d0c000c33
a3a3a3a3a3a3a3a3a3a3a3a30f05010001000034
353525a3a3a3a3a3a3a3a3a3a3a3331532132515

image outdoors
location 17 18
sprite @17,8 candle3
sprite @17,1 wind
sprite @1,1 bonfire
sprite @4,2 bonfire
sprite @14,2 bonfire
