2425141214243215332525351325152627282333
3332231313143323352324341322242627282422
3515341225221424322335242435342627282232
2325223433141617171834131233242627282534
3434142415162a27272917171717172a27282413
1525332215262727272719373737371a27283324
1332153335361a27271938252422342627282232
2234323215233637373835251222142627281532
1534323513133524321515353335242627281323
2334331212252432253322153212242627282232
2512251522223312321415223515132627282535

image outdoors
location 15 17
