1525243412233413132315221414223514132334
3214133515323214223423331433352225223412
2325342512251232333234251422351335242514
1415322413153524251323222222252412241414
3212323432331223153432131224231312151524
3515331334241235223532323412152325132533
1433221434331315131212143422121322152534
3334123232331524251232231235343525231215
3534232435143532142525331525142523323435
2222322433353333143422142333331323142533
1533222424232225233213133533123225332325

image outdoors
location 17 17
