222512153213352313148b8c8d14353423351412
3525131313243222122222243213132212131234
1512323434322215232333222322331235222325
3324331233424344331433331313231514352333
1333331325525354121425133524141522152325
3422142534241323241515121523231423151513
3332122514233525351525122224242433221315
1412233535352424323435232533123323322415
2232122314321433233415152235351425353322
3214142325231214333234331234143522352432
3213321415221434351325121423153523233233

image outdoors
location 16 19
