8788153525143434251535251524233333133386
8788132515010100001b1d1f001333222525768a
8788223500000001003b3c3d0001343512768a79
8788230001000709000b030400020525768a8788
97980100013e3f01050016171717171896979798
0000000b09000d0202162a272727272917171717
7777780a0000000c162a27272727271937373737
8787881302233301262727272727272876777777
8787883425321433363737373737373886878787
878789781b1d1f2234341476777777778a878787
878787886b6c6d33332313868787878787878787

image image:outdoors
location 14 17
