8787878779979797979797977a877997977a8787
8787878788000006000001008679983533868779
8787878789777777777777778a88223324967a88
7997979797979797979797979798013512339698
880a0000010100000c0002010600070216171717
880031000e020000010000010000020136373737
880202020900000f0002000700000a0400007677
8978000e0024223300000006000002030a02967a
87897712233215321409020000003e3f1b1d1f86
878789777822231223242500060000006b6c6d86
878787878978152232333335321534337677778a

image image:outdoors
location 14 15
sprite @8,5 sprite:raccoon
