87878787877997979797979797979797977a8787
87878787799800000b0000000002000000967a87
8787877998020b010202020b0c0200000002967a
8787878800020203020100040000010c00000b86
87878788090a090d0b03000a00000200000a0296
878787880d0202040e0500010000010000000b08
97979798050b0002020001020a02000f04090976
030a0230000701020102070201000d0103080086
77777777780000020e00000001010e0102060086
87878787897778000d070c02000001000000768a
8787878787878977777777777777777777778a87

image image:outdoors
location 13 17
sprite @6,3 sprite:target
sprite @3,7 sprite:lock
