1512133233353432233334152415251534133313
0002000025222413250102010101020b01000015
000002000a0203040107091b1c1f0000010f0035
02000d23010000000c00002b2c2d000013000b12
050002010000020b0f000100000b000003000134
0004000000000d0e2323150e0000090002000023
0001000a00000c340004090501002e2f02000235
0000000012000022140102000f020d0202000212
010200000d0a0200330e00000500000000000135
1501000000040601000100000102020d00010932
1214321213243432341524343335322523143432

image outdoors
location 17 16
