1512133233353432233334152415251534133313
0002000025222413250102000201030b01000015
000002000a0203040107000000000000010f0035
02000d23010000000c0000000001000013000b12
0500020100000101020000013432080003000134
0004000000000012332313330503000000000023
0001000a00000015020400010024060000000235
0000000012000022140102000102000000000212
010200000d0a0200330e00000500000000000135
1501000000040601000100000102020d00010932
1214321213243432341524343335322523143432

image outdoors
location 17 16
