2213123324122534352234152415251525121523
15321212f400000a000002010102000000152513
221232000a0005161718001b1d1f0a0100093432
143501080000162a2728005b5c5d3e3f04030012
3512040f16172a272728020900000b000001e2e3
010102002627272727280200050c00060f00f2f3
00010500361a2727193809000c000d0006000235
0000030500363737380a00010200010200000333
0509000009000e02020007253303020005012423
222423f400040001010e331534320400f4151513
3414342212243432341422333323141325343514

image outdoors
location 17 16
