878787799797979797977a878787878787878787
87878788161717171718967a8787878787878787
878787882619371a272918868787878787878787
8787878826284e26272728868787878787878787
878787882629172a271938969797979797977a87
87878788363737373738000602000205000f8687
9797979800010200060001070000030200009697
0e00300101000202010100000c02000002000200
7777780200000e0000040000040f000800767777
87878977777802000200060c00000400768a8787
878787878789777777777777777777778a878787

image image:outdoors
location 12 17
sprite @6,3 sprite:target
sprite @4,6 sprite:cannon
sprite @2,7 sprite:lock
