1415221222132525232215123513241312122535
1335353535122414152335132523332323152425
2215231413333524351312142314341534132313
23151423221534231b1e1f324243442434141212
14241512222223348b8c8d355253543522131332
1524222224141222143535253414152233342225
3524341532122313131312322313252312243534
2232222314133235343413342313133224352325
1223123422333334142313321232223325341524
2334333522143414222214342433243532353235
1432122412322434353313121323131413252523

image outdoors
location 16 17
