2524143223243202000000000026272728000024
1400010d01000e0000000d000026272728000113
350f02010f020007000101000226271938000032
23071b1d1f01000001020100162a272809070023
35005b5c5d0001000000020d2627272801000534
13040000080f06000000040a4647474800000222
2401001b1d1f010200020c005657575802010234
3501016b6c6d3e3f020000006667676801000115
1300000a050105000b0000002627272801000925
35020100070008000b0000022627272800010233
3422341514322524231534342627272812352513

image outdoors
location 16 17
