2524143223243202000000000000000135332224
1400010d01000e0000000d000001000c01050213
3503000000060007000101020000000202030032
2300000001010000010201040400000000000023
3506000006010100000002050201080002000534
130200000000000000000400000e010000000222
2401000000000e0000020c000000000201010234
35010000040f0002020000070006020000000115
1300000000000000000000000000000000000925
35020100070008000b0000020006060a02010233
3422341514322524231534123214343314352513

image outdoors
location 16 17
