1415221222132525232215123513241312122535
1335353535122414152335132523332323152425
2215231413333522141523323334121434132313
2315142322153434332314141512341334141212
1424151222222313323215253233123322131332
1524222224141215151335142213151433342225
3524341532122313131312322313252312243534
2232222314133235343413342313133224352325
1223123422333334142313321232223325341524
2334333522143414222214342433243532353235
1432122412322434353313121323131413252523

image outdoors
location 16 17
