0100000825341234252233132534253322223235
090002010000010413251412011b1e1f00020007
03000000250008012513243302abacad00000000
1300000200000915151314030000000002320000
1402000308021235323401010c000b0200080008
250000020000253224010100000100000e010201
330432080b232515000200020224020700000b00
330f000904242200060500000000080000000000
230b0102013234060000000d01010023010a0323
140000051312133212000000000b0f01010d1534
2324222433152524351532152435331212142532

image outdoors
location 15 16
