1315132314121312252523332433332412353235
13242525152222221524231b1e1f040200000007
35221214253212352300009b9c9d0100000f0000
25323532243534150e0000000001070002320000
3434000c020f12000004000f00000b0200080008
05000200020d320000000b00000100000e010201
000b010000021406010100020224020700000b00
0003020002352302060a00000000080000000000
34061312342313232400080201010023010a0323
132412143314131324223500000b0f01010d1534
3514241432153335253414352435331212142532

image outdoors
location 15 16
