0100000825341232152533151234253322223235
0900020008000100010100070a00020000020007
030000050006010c01000f010000000003040000
1300000000000000000000000000000000000900
1402000200000600000204000c000b0200000208
25010800030a000201000100000000000e010201
3302000000010d00000000000002000700000b00
33090702000f000c01050008040e010201000000
230b0000000202020002000000000000000a0323
14000c010002000202000000000b0102000d1534
2324221334322433252332152435331212142532

image outdoors
location 15 16
