3235133533221324231213141333153413123422
3413323532132532323534142424343425233333
2315332535020200000000000135242524153425
32222401010700080000000e0102121513332335
35251302000001011b1e1f0f0009352314323233
35241500000000009b9c9d000001003422351312
12352222000f0200000000000e0208000e332223
1314232215080606000c01090125250e00020200
1412132222250000000100002233230000010100
32253432251224120700352324252335020d0009
2412242435332525323315321523341502000000

image outdoors
location 14 15
