2333121514323334243513143515133332221234
171717171802000c000f00010d00000107153433
272727272918000201000100080f0f0001062534
2727272727280207020c00000205000000003522
27272727272802011b1c1f081b1d1f0500000001
2727272727280d002b2c2d006b6c6d0202000b00
272727271938020c002e2f00003e3f0000063412
272727272800010a0903000d020f0c0507053425
272727193800000108000f0001000e0304331312
373737380c000c0002080100020b000625241222
1315232235131215142413241332352325242424

image outdoors
location 16 18
