3515141214221233343513332233332222321314
15000100000000000e0402020f00060001000024
14000200070000070a0100000002000002000112
330f0001010000080000000e0e02000100010132
14080202000001010200050f0000010100000022
220d0c00050000000000000000000a0e05020f15
120d000000010200000000000000000001010115
1207030a00040006000c0100000f060201000503
2502000000000000000000000203030000010100
1502000c020100000008000000020100000d0009
2514233224243235253434151534143201000000

image outdoors
location 14 15
