2333121524331523243534321315132223331234
17171717181324121b1c1f341b1d1f3224231233
2727272728002e2f2b2c2d026b6c6d3e3f241434
272727193807000d00010c0300070b01090b1522
272727280001000000010c080000020601000001
27272728000001000005000000010e0800000b00
272727291718000000020300000a020c0a083412
27272727272918040001010100000c0602053425
27272727272729180001000001000e0304331312
373737373737373806000a00020b000625241222
142433331522133524321b1e1f32352325242424

image outdoors
location 16 18
