a3a3a3a3a3a3a315121322331534151512331215
a3f4f4f4f4f4a313251324223525143415353414
a3f4f4f4f4f4a313221534243512243333153314
a3f4f4f4f4f4a322333523351435122312153334
a3a3a3e0e1a3a32200011b1c1f00020a14142232
a3a3a3f0f1a3a30f02024b4c4d00010000000000
251300000b02000a0d002e2f017002010d020001
1325000001000102020701000101010000000c00
3333020e020c0008000001020502000100010234
2333000301020c0c0001010a0200022515221322
3222242323253422353322132333151434132334

image outdoors
location 14 16
sprite @2,2 candle1
