a3a3a3a3a3a3a3a3a31232331534151512331215
a3f4f4f4f4f4f4f4a32433223525143415353414
a3f4f4f4f4f4f4f4a31422243512243333153314
a3f4f4f4f4f4f4f4a32332351435122312153334
a3a3a3a3a3a3e0e1a3001b1c1f00020a14142232
a3a3a3a3a3a3f0f1a3014b4c4d2e2f0000000000
25130d0008000a000f020001067002010d020001
13250000010001020200000e0001010000000c00
3314120c000c0008000001020502000100010234
2312351307020c0c0001010a0200022515221322
3232333233253422353322132333151434132334

image outdoors
location 14 16
sprite @2,2 candle1
