2235252414141435351334143522233402000000
1300000001000e0f0300010001000e0102010e00
121b1d1f000000000000010b0500000001000f0e
357b7c7d00073e3f00010200060d000201000025
3300000009010002010000000909000002000213
2403020000050300020800000100000000000014
15140d00000000040d0000000000000b0d020125
1325000001000102020209000001010000000222
3333020e020c0008000001020505000000020012
2333000301020c0c0001010a0200010103000114
3222242323253422353322132325232534152215

image outdoors
location 14 16
