1415243322133425222232143415253235132333
350c09000200050f0f02020035233314000b0322
230000010f0202010200020202040c0002000535
330e0008081b1e1f00020000000b010b03010e12
14010201002b2c2d0100010300000c0004000100
34020a0308010100020a000207060c0906000000
23000b000001000f060000010100000000000f01
000000010000000000000001020000000f043424
000000000000050700090201020900010e323322
01000000020f0013322432252215233424241325
020c020835132323251315222333142213121214

image outdoors
location 15 15
