3333331412332514251423151213232627281323
3335221216171717171717171717172a27291717
241516172a272727272727272727272727272727
22162a27193737371a2727272727272727272727
32262727281b1e1f262727272727272727272727
1526272728abacad262727272727272727272727
33262727291717172a2727272727272727272727
1226272727272727272727272727272727272727
25361a2727272727272727272727272727272727
2512363737373737373737373737373737373737
2332321325352413143325332222253213222223

image outdoors
location 15 18
