1415243322133425222232143415253235132333
350c09000200050f0f02020035233314000b0322
230000010f0202010200020202040c0002000535
330e0008081b1e1f00020000000b010b03010232
14010201008b8c8d0100010300000c0004000435
34020a0308010100020a000207060c0906000034
23000b000001000f060000010100000000000034
000000010000000000000001020000000f043332
000000000000050700090201020900010e323322
01000000020f0013322432252215233424241325
020c020835132323251315222333142213121214

image outdoors
location 15 15
