b4b4a5a6a1a2a5a6a3e0e1a3a1a2a5a6a2a1b4b4
b4b4a5c6c7a2a5a6a3f0f1a3a1a2a5c6c7a1b4b4
b4b4b5d6d7b2b5b600010201b1b2b5d6d7b2b4b4
7734010006000205040000000200010202002275
87250000000a0800020604050001020000003285
8732000000050035321213351201010000021485
8722010000020023322e2f332300000001153485
873501000000000200010a000001000a00241485
8877342501010301000200000002050000122485
868876767676770005010b000a75767676767689
86868686868687020b0002017589868686868686

image outdoors
location 16 15
