b4b4a5a6a1a2a5a6a3e0e1a3a1a2a5a6a2a1b4b4
b4b4a5999aa2a5a6a3f0f1a3a1a2a5999aa1b4b4
b4b4b5a9aab2b5b600010201b1b2b5a9aab2b4b4
3334010006000205040000000200010202001234
34240000000a0800020604050001020000001524
3415000000050035321213351201010000023413
3522010000020023322e2f332300000001153512
123300000000000200010a000001000a00242213
3514241300010005000200000006020101221225
133314342534340005010b0e0523353234143423
321535331315350d0b0002033232132234321322

image outdoors
location 16 15
