a2a2949590919495a3e0e1a3909194959091a2a2
a2a294c6c7919495a3f0f1a3909194c6c791a2a2
a2a2a4d6d7a1a4a500010201a0a1a4d6d7a1a2a2
7824010006000205040000000200010202003276
88120000000a0800020604050001020000001486
8813000000050035321213351201010000021286
8832010000020023322e2f332300000001152286
881201000000000200010a000001000a00242286
897832140302020000020000000500050b323586
878977777777780005010b02007677777777778a
87878787878788000b000201768a878787878787

image outdoors
location 16 15
