2323341532352314353332233524321214252522
2532351413232234122423342325321312153212
1512223322342413341222323333332234142433
2422140008080000000100010014322333242522
0102010f00000e00020100000902040024241312
0000000000000009020000000000000032223213
0000020000080000000702070502000400122425
32000d0f0e05000a010000010000000000242213
34070100010000000000090f0109000000221225
330001070000000b050001000000000001323323
35000700070d06010b000201020000000d001422

image outdoors
location 16 15
