b4b4a5a6a1a2a5a6a3e0e1a3a1a2a5a6a2a1b4b4
b4b4a5999aa2a5a6a3f0f1a3a1a2a5999aa1b4b4
b4b4b5a9aab2b5b600010201b1b2b5a9aab2b4b4
33340100060001000300000c0001010202001234
34240000000a0701000001000e00020000001524
3415000201000609020000020e00010000023413
3524011b1c1f0000002e2f070500000001153512
2522014b4c4d000a010000000002000a00242213
120f000001000000000200000101000200221225
330001070000000b05010b000000000001323323
35000700070d06010b000201020000000d001422

image outdoors
location 16 15
