b4b4a5a6a5a6a1a2a3a4a5a6b472b4a1a2a1a2b3
b4b4a5a6a5a6a1a2a3a4a5a6818283a1a2a1a2b3
b4b4a5a6a5999aa2a3a4a5a6919293a1a2a1a2b3
b4b4a5a6b5a9aab2b3b4b5b6000000b1b2a1a2b3
b4b4b5b6090600022e2f0100000c000c02b1b2b3
3414010000000609020000000000000402000032
352401000d3200000007020705000b0001353334
2522010f0101000a0100010b0000130600242213
120f000001000000000115000100000800221225
330001070000000b05060a020000000001323323
35000700070d06010b000201020000000d001422

image outdoors
location 16 15
